10 10
*
##########
#__T#T___#
#######__#
#d#d#d#_##
#_#_#_#_##
#_______##
#D########
#_W_F__#X#
#w#f#b_B_#
##########
*
8 5 0 
*
2 4 3
*
4 9 6 9
6 9 4 9
*
0 0 0 0 0 false false 12142
*
