10 10
*
##########
#__T#T__r#
#######__#
#d#d#d#R##
#_#_#_#_##
#_______##
#D########
#_W_F__#X#
#w#f#b_B_#
##########
*
2 9 0 null
*
2 4 3
*
4 9 6 9
*