12 12
*
############
#___r___F__#
#_______F__#
#_#####_F__#
#_#####_F__#
#___s___F__#
#_______F_X#
##R#____F__#
#__#____F__#
#_###___F__#
#f__#___F__#
############
*
2 7 0 -1
7 2 2 -1
*
*
*
0 0 0 0 0 false false 0 0
*