10 10
*
##########
#_______r#
#________#
#___##___#
#___##___#
#________#
#________#
#R########
#_______X#
##########
*
2 2 0 null
2 7 1 h
5 6 2 h
*
*
*