20 20
*
####################
#___#___X________#_#
#_T_#_T_#WWW_FFF_#D#
#___#___#_w___f__#_#
#__________________#
#_____________b_B__#
#_###W#####___###__#
#_#_____#_#___g_G__#
#_##_####_#___###__#
#_#_____#_#___r_R__#
#_#_#_#___#___###__#
#_#########___ddd__#
#__________________#
#_##W##_##W##_#W##_#
#_#___#_#___#_#__#_#
#_#___#_#___#_#__#_#
#_#___#_#___#_#__#_#
#_#####_#####_####_#
#__________________#
####################
*
10 2 0 null
17 5 1 v
12 5 2 null
5 5 3 null
5 11 4 null
*
19 18 3
*
3 18 7 18
*