19 9
*
###################
#___b___#X#_______#
#_#####_#_#_#####_#
#_#####_#_#_#r__#_#
#_#####_#_#_###_#_#
#_______#_#_____#_#
#######R#B#######_#
##________________#
###################
*
3 2 0 null
8 4 2 north
*
*
*
0 0 0 0 0 false false 0
*