12 12
*
############
#___r___#X_#
#B#######__#
#_______##T#
#__________#
#__________#
#__________#
#__________#
#_______##R#
######G##__#
#b______#t_#
############
*