10 10
*
##########
#_______X#
#________#
#T_______#
##########
#T_______#
#________#
#________#
#________#
##########
*
2 2 0 -1
9 8 2 -1
*
*
2 5 2 7
*
0 0 0 0 0 false false 0
*