10 10
*
##########
#__T#T___#
#######__#
#_#_#_#_##
#_#_#_#_##
#_______##
#_########
#_W_F__#X#
#_#f#b_B_#
##########
*
2 2 0 
*
*
4 9 6 9
6 9 4 9
*
